5 10
|--------|
|...|..-.|
|..-|.@P.|
|.F....-.|
|--------|